,Region,Area,Electorate,Pct_Turnout,Valid_Votes,Remain,Leave,Pct_Remain,Pct_Leave
0,East,Peterborough,120892,72.35,87392,34176,53216,0.39106554375686564,0.6089344562431344
1,East,Luton,127612,66.31,84481,36708,47773,0.43451190208449236,0.5654880979155076
2,East,Southend-on-Sea,128856,72.9,93870,39348,54522,0.41917545541706613,0.5808245445829339
3,East,Thurrock,109897,72.75,79916,22151,57765,0.27717853746433757,0.7228214625356625
4,East,Bedford,119530,72.06,86066,41497,44569,0.4821532312411405,0.5178467687588595
5,East,Central Bedfordshire,204004,77.89,158804,69670,89134,0.4387169088939825,0.5612830911060175
6,East,Cambridge,80108,72.22,57799,42682,15117,0.7384556826242669,0.26154431737573314
7,East,East Cambridgeshire,62435,77.08,48086,23599,24487,0.4907665432766294,0.5092334567233706
8,East,Fenland,71447,73.69,52626,15055,37571,0.2860753239843423,0.7139246760156577
9,East,Huntingdonshire,128486,77.82,99927,45729,54198,0.45762406556786456,0.5423759344321355
10,East,South Cambridgeshire,114830,81.21,93189,56128,37061,0.6023028469025314,0.39769715309746856
11,East,Basildon,132771,73.86,97999,30748,67251,0.31375830365615975,0.6862416963438402
12,East,Braintree,112562,76.67,86236,33523,52713,0.38873556287397376,0.6112644371260263
13,East,Brentwood,58777,79.5,46704,19077,27627,0.4084660842754368,0.5915339157245632
14,East,Castle Point,68860,75.38,51845,14154,37691,0.27300607580287395,0.726993924197126
15,East,Chelmsford,129971,77.6,100794,47545,53249,0.4717046649602159,0.5282953350397841
16,East,Colchester,127520,75.11,95719,44414,51305,0.4640040117427052,0.5359959882572948
17,East,Epping Forest,100016,76.89,76852,28676,48176,0.37313277468380784,0.6268672253161922
18,East,Harlow,59124,73.56,43469,13867,29602,0.31900894890611703,0.680991051093883
19,East,Maldon,49073,79.17,38831,14529,24302,0.3741598207617625,0.6258401792382375
20,East,Rochford,66589,78.81,52447,17510,34937,0.33386085000095334,0.6661391499990467
21,East,Tendring,111167,74.4,82657,25210,57447,0.3049953421972731,0.6950046578027269
22,East,Uttlesford,64735,80.28,51943,25619,26324,0.493213715033787,0.5067862849662129
23,East,Broxbourne,68997,73.78,50872,17166,33706,0.3374351313099544,0.6625648686900456
24,East,Dacorum,108965,79.21,86244,42542,43702,0.49327489448541345,0.5067251055145865
25,East,Hertsmere,73295,76.62,56125,27593,28532,0.4916347438752784,0.5083652561247216
26,East,North Hertfordshire,99316,78.27,77672,42234,35438,0.5437480688021423,0.4562519311978577
27,East,Three Rivers,67380,78.5,52848,25751,27097,0.4872653648198607,0.5127346351801393
28,East,Watford,65060,71.68,46586,23167,23419,0.49729532477568367,0.5027046752243163
29,East,Breckland,98989,74.34,73548,26313,47235,0.3577663566650351,0.6422336433349649
30,East,Broadland,99254,78.37,77737,35469,42268,0.4562692154315191,0.5437307845684809
31,East,Great Yarmouth,72634,69.06,50128,14284,35844,0.28495052665177145,0.7150494733482285
32,East,King's Lynn and West Norfolk,113884,74.75,85080,28587,56493,0.3360014104372355,0.6639985895627645
33,East,North Norfolk,83065,76.84,63790,26214,37576,0.41094215394262423,0.5890578460573758
34,East,Norwich,96091,69.12,66366,37326,29040,0.5624265437121417,0.43757345628785826
35,East,South Norfolk,102395,78.54,80358,38817,41541,0.4830508474576271,0.5169491525423728
36,East,Babergh,70628,78.26,55242,25309,29933,0.45814778610477536,0.5418522138952246
37,East,Forest Heath,38527,72.62,27951,9791,18160,0.3502915816965404,0.6497084183034596
38,East,Ipswich,91574,72.51,66353,27698,38655,0.4174340270974937,0.5825659729025063
39,East,Mid Suffolk,78325,78.16,61185,27391,33794,0.44767508376236004,0.5523249162376399
40,East,St Edmundsbury,81148,76.72,62210,26986,35224,0.43378877993891657,0.5662112200610834
41,East,Suffolk Coastal,98195,80.68,79184,37218,41966,0.47001919579713075,0.5299808042028693
42,East,Waveney,90391,72.67,65646,24356,41290,0.3710203211162904,0.6289796788837096
43,East,St Albans,104859,82.51,86445,54208,32237,0.6270808028226039,0.372919197177396
44,East,Welwyn Hatfield,78146,75.04,58610,27550,31060,0.47005630438491725,0.5299436956150827
45,East,East Hertfordshire,106260,80.4,85366,42372,42994,0.4963568633882342,0.5036431366117659
46,East,Stevenage,62156,73.7,45785,18659,27126,0.4075352189581741,0.5924647810418259
47,East Midlands,Derby,171246,70.53,120655,51612,69043,0.4277651154117111,0.572234884588289
48,East Midlands,Leicester,213819,65.15,138972,70980,67992,0.5107503669803989,0.48924963301960106
49,East Midlands,Rutland,29390,78.2,22966,11353,11613,0.4943394583297048,0.5056605416702952
50,East Midlands,Nottingham,195394,61.82,120661,59318,61343,0.49160872195655597,0.5083912780434441
51,East Midlands,Amber Valley,96760,76.34,73820,29319,44501,0.3971687889460851,0.6028312110539149
52,East Midlands,Bolsover,58063,72.33,41972,12242,29730,0.2916706375679024,0.7083293624320975
53,East Midlands,Chesterfield,79905,71.92,57424,22946,34478,0.39958902201170243,0.6004109779882976
54,East Midlands,Derbyshire Dales,57075,81.92,46728,22633,24095,0.4843562746105119,0.5156437253894881
55,East Midlands,Erewash,87596,75.99,66530,25791,40739,0.3876597023898993,0.6123402976101007
56,East Midlands,High Peak,72487,75.69,54833,27116,27717,0.4945197235241552,0.5054802764758448
57,East Midlands,North East Derbyshire,78855,75.25,59310,22075,37235,0.37219693137750803,0.627803068622492
58,East Midlands,South Derbyshire,73856,76.8,56695,22479,34216,0.39648999029896814,0.6035100097010319
59,East Midlands,Blaby,73832,76.54,56471,22888,33583,0.40530537798161886,0.5946946220183811
60,East Midlands,Charnwood,133780,70.46,94172,43500,50672,0.4619207407722041,0.538079259227796
61,East Midlands,Harborough,67420,81.44,54878,27028,27850,0.4925106600094756,0.5074893399905245
62,East Midlands,Hinckley and Bosworth,85305,76.8,65470,25969,39501,0.3966549564686116,0.6033450435313884
63,East Midlands,Melton,37273,81.36,30305,12695,17610,0.41890777099488535,0.5810922290051147
64,East Midlands,North West Leicestershire,73944,77.95,57611,22642,34969,0.39301522278731493,0.6069847772126851
65,East Midlands,Oadby and Wigston,42684,73.77,31465,14292,17173,0.45421897346257745,0.5457810265374226
66,East Midlands,Boston,39363,77.27,30404,7430,22974,0.24437574003420603,0.755624259965794
67,East Midlands,East Lindsey,107009,74.93,80128,23515,56613,0.2934679512779553,0.7065320487220448
68,East Midlands,Lincoln,63351,69.34,43894,18902,24992,0.4306283318904634,0.5693716681095367
69,East Midlands,North Kesteven,86468,78.4,67753,25570,42183,0.377400262718994,0.622599737281006
70,East Midlands,South Holland,65701,75.37,49497,13074,36423,0.2641372204376023,0.7358627795623978
71,East Midlands,South Kesteven,105457,78.25,82471,33047,49424,0.4007105528003783,0.5992894471996217
72,East Midlands,West Lindsey,73499,74.53,54753,20906,33847,0.38182382700491296,0.618176172995087
73,East Midlands,Corby,43313,74.1,32081,11470,20611,0.3575324958698295,0.6424675041301705
74,East Midlands,Daventry,61004,81.01,49381,20443,28938,0.4139851359834754,0.5860148640165246
75,East Midlands,East Northamptonshire,68334,76.99,52574,21680,30894,0.41237113402061853,0.5876288659793815
76,East Midlands,Kettering,70570,76.43,53907,21030,32877,0.39011631142523234,0.6098836885747676
77,East Midlands,Northampton,144948,72.68,105259,43805,61454,0.41616393847556976,0.5838360615244302
78,East Midlands,South Northamptonshire,71309,79.46,56624,25853,30771,0.45657318451539985,0.5434268154846001
79,East Midlands,Wellingborough,54572,75.46,41141,15462,25679,0.3758294645244403,0.6241705354755597
80,East Midlands,Ashfield,91916,72.83,66899,20179,46720,0.3016338061854437,0.6983661938145562
81,East Midlands,Bassetlaw,85547,74.82,63967,20575,43392,0.3216502258977285,0.6783497741022715
82,East Midlands,Broxtowe,83593,78.32,65426,29672,35754,0.45352000733653286,0.5464799926634671
83,East Midlands,Gedling,88298,76.6,67577,30035,37542,0.44445595394882875,0.5555440460511712
84,East Midlands,Mansfield,77624,72.62,56344,16417,39927,0.29137086468834306,0.7086291353116569
85,East Midlands,Newark and Sherwood,87338,76.86,67087,26571,40516,0.3960677925678596,0.6039322074321404
86,East Midlands,Rushcliffe,86401,81.56,70410,40522,29888,0.5755148416418122,0.42448515835818773
87,London,City of London,5987,73.58,4399,3312,1087,0.7528983859968175,0.24710161400318253
88,London,Barking and Dagenham,115812,63.85,73880,27750,46130,0.37560909583107743,0.6243909041689226
89,London,Barnet,223467,72.14,161033,100210,60823,0.6222948091384995,0.37770519086150045
90,London,Bexley,170779,75.28,128489,47603,80886,0.37048307637229644,0.6295169236277035
91,London,Brent,186793,65.14,121404,72523,48881,0.5973691146914435,0.40263088530855656
92,London,Bromley,231473,78.87,182432,92398,90034,0.5064791264690405,0.49352087353095947
93,London,Camden,145425,65.52,95133,71295,23838,0.7494244899246318,0.25057551007536816
94,London,Croydon,245349,69.81,171134,92913,78221,0.5429254268584852,0.45707457314151484
95,London,Ealing,212991,70.08,149041,90024,59017,0.6040217121463222,0.39597828785367783
96,London,Enfield,198387,69.09,136906,76425,60481,0.5582297342702293,0.4417702657297708
97,London,Greenwich,168967,69.52,117365,65248,52117,0.5559408682315852,0.44405913176841477
98,London,Hackney,163284,65.18,106266,83398,22868,0.7848041706660644,0.2151958293339356
99,London,Hammersmith and Fulham,114863,69.95,80242,56188,24054,0.700231798808604,0.299768201191396
100,London,Haringey,150098,70.64,105846,79991,25855,0.7557300228634053,0.24426997713659468
101,London,Harrow,162397,72.26,117225,64042,53183,0.5463169119215184,0.45368308807848157
102,London,Havering,183082,76.02,139086,42201,96885,0.30341659117380615,0.6965834088261939
103,London,Hillingdon,193033,68.99,133022,58040,74982,0.43631880440829335,0.5636811955917066
104,London,Hounslow,165050,69.8,115076,58755,56321,0.5105756195905314,0.4894243804094685
105,London,Islington,144514,70.39,101600,76420,25180,0.7521653543307086,0.24783464566929134
106,London,Kensington and Chelsea,83042,65.99,54739,37601,17138,0.6869142658799028,0.3130857341200972
107,London,Kingston upon Thames,108838,78.4,85270,52533,32737,0.6160783393925179,0.3839216606074821
108,London,Lambeth,210800,67.44,141924,111584,30340,0.7862236126377498,0.21377638736225021
109,London,Lewisham,197514,63.1,124473,86955,37518,0.698585235352245,0.30141476464775496
110,London,Merton,136352,73.49,100100,63003,37097,0.6294005994005994,0.3705994005994006
111,London,Newham,176985,59.25,104699,55328,49371,0.52844821822558,0.47155178177442003
112,London,Redbridge,189843,67.63,128233,69213,59020,0.5397440596414339,0.46025594035856604
113,London,Richmond upon Thames,132632,82.09,108806,75396,33410,0.6929397275885522,0.3070602724114479
114,London,Southwark,195875,66.2,129502,94293,35209,0.7281200290343006,0.2718799709656994
115,London,Sutton,140288,76.01,106560,49319,57241,0.46282845345345347,0.5371715465465465
116,London,Tower Hamlets,167820,64.6,108235,73011,35224,0.6745599852173512,0.3254400147826489
117,London,Waltham Forest,162983,66.69,108551,64156,44395,0.5910217317205737,0.40897826827942624
118,London,Wandsworth,219521,71.98,157884,118463,39421,0.7503166882014644,0.24968331179853565
119,London,Westminster,120524,64.99,78196,53928,24268,0.6896516445854007,0.3103483554145992
120,North East,Hartlepool,70341,65.59,46100,14029,32071,0.3043167028199566,0.6956832971800434
121,North East,Middlesbrough,94612,64.89,61358,21181,40177,0.3452035594380521,0.654796440561948
122,North East,Redcar and Cleveland,103529,70.26,72714,24586,48128,0.3381192067552328,0.6618807932447671
123,North East,Stockton-on-Tees,141486,71.0,100415,38433,61982,0.3827416222675895,0.6172583777324105
124,North East,Darlington,77662,71.07,55166,24172,30994,0.43816843708081066,0.5618315629191893
125,North East,County Durham,389507,68.69,267398,113521,153877,0.42453945055684783,0.5754605494431522
126,North East,Northumberland,240496,74.35,178721,82022,96699,0.45893879286709455,0.5410612071329055
127,North East,Newcastle upon Tyne,190735,67.67,129003,65405,63598,0.5070037130919436,0.4929962869080564
128,North East,North Tyneside,156993,72.3,113462,52873,60589,0.4659974264511466,0.5340025735488534
129,North East,South Tyneside,115893,68.27,79079,30014,49065,0.3795445061267846,0.6204554938732154
130,North East,Sunderland,207221,64.86,134324,51930,82394,0.38660254310473186,0.6133974568952681
131,North East,Gateshead,145866,70.62,102958,44429,58529,0.43152547640785566,0.5684745235921443
132,North West,Halton,95289,68.26,65005,27678,37327,0.42578263210522266,0.5742173678947773
133,North West,Warrington,157042,73.36,115144,52657,62487,0.45731431946084905,0.542685680539151
134,North West,Blackburn with Darwen,100117,65.33,65321,28522,36799,0.4366436521180019,0.5633563478819982
135,North West,Blackpool,102354,65.42,66927,21781,45146,0.3254441406308366,0.6745558593691634
136,North West,Cheshire East,285957,77.36,221125,107962,113163,0.48823968343697005,0.51176031656303
137,North West,Cheshire West and Chester,259878,74.51,193537,95455,98082,0.49321318404232783,0.5067868159576722
138,North West,Allerdale,74426,72.92,54238,22429,31809,0.41352925992846346,0.5864707400715365
139,North West,Barrow-in-Furness,53194,67.87,36074,14207,21867,0.39382935077895437,0.6061706492210456
140,North West,Carlisle,80124,74.54,59683,23788,35895,0.3985724578188094,0.6014275421811907
141,North West,Copeland,54206,70.06,37947,14419,23528,0.3799773368118692,0.6200226631881308
142,North West,Eden,41872,75.82,31718,14807,16911,0.46683271328583137,0.5331672867141686
143,North West,South Lakeland,81948,79.78,65331,34531,30800,0.5285545912354013,0.47144540876459873
144,North West,Burnley,64461,67.25,43316,14462,28854,0.33387201034259856,0.6661279896574014
145,North West,Chorley,84159,75.52,63515,27417,36098,0.4316618121703535,0.5683381878296465
146,North West,Fylde,61174,75.57,46206,19889,26317,0.43044193394797214,0.5695580660520279
147,North West,Hyndburn,62042,64.74,40137,13569,26568,0.3380671201136109,0.6619328798863892
148,North West,Lancaster,100567,72.69,73041,35732,37309,0.4892046932544735,0.5107953067455265
149,North West,Pendle,64534,70.33,45335,16704,28631,0.36845704202051394,0.631542957979486
150,North West,Preston,94284,68.72,64745,30227,34518,0.46686230596957295,0.5331376940304271
151,North West,Ribble Valley,46148,79.02,36442,15892,20550,0.43609022556390975,0.5639097744360902
152,North West,Rossendale,52750,72.43,38181,15012,23169,0.39317985385401116,0.6068201461459889
153,North West,South Ribble,84573,75.38,63724,26406,37318,0.41438076705793736,0.5856192329420626
154,North West,West Lancashire,85834,74.47,63869,28546,35323,0.4469460927836666,0.5530539072163334
155,North West,Wyre,84471,74.61,62979,22816,40163,0.3622794899887264,0.6377205100112736
156,North West,Bolton,197109,70.1,138080,57589,80491,0.41706981460023174,0.5829301853997683
157,North West,Bury,141600,71.43,101028,46354,54674,0.4588232965118581,0.541176703488142
158,North West,Manchester,338064,59.77,201814,121823,79991,0.6036399853330294,0.3963600146669706
159,North West,Oldham,158084,68.0,107403,42034,65369,0.39136709402903086,0.6086329059709692
160,North West,Rochdale,156621,65.97,103231,41217,62014,0.3992695992482878,0.6007304007517121
161,North West,Salford,173668,63.3,109815,47430,62385,0.4319082092610299,0.5680917907389701
162,North West,Stockport,221162,73.97,163489,85559,77930,0.5233318449559298,0.47666815504407023
163,North West,Tameside,168047,66.06,110947,43118,67829,0.388636015394738,0.611363984605262
164,North West,Trafford,165294,75.86,125311,72293,53018,0.5769086512756263,0.42309134872437376
165,North West,Wigan,235982,69.23,163273,58942,104331,0.36100273774598374,0.6389972622540163
166,North West,Knowsley,111647,63.54,70903,34345,36558,0.48439417231993004,0.5156058276800699
167,North West,Liverpool,317924,64.08,203554,118453,85101,0.5819242068443754,0.41807579315562454
168,North West,St. Helens,136096,68.86,93679,39322,54357,0.41975255927155497,0.580247440728445
169,North West,Sefton,206298,71.73,147878,76702,71176,0.5186843208590866,0.48131567914091344
170,North West,Wirral,242568,70.96,172000,88931,83069,0.5170406976744186,0.4829593023255814
171,Northern Ireland,Northern Ireland,1260955,62.69,790149,440707,349442,0.557751765806196,0.44224823419380394
172,Scotland,Clackmannanshire,37841,67.23,25427,14691,10736,0.5777716600464073,0.42222833995359266
173,Scotland,Dumfries and Galloway,115837,71.41,82667,43864,38803,0.5306107636662756,0.4693892363337245
174,Scotland,East Ayrshire,91977,62.91,57833,33891,23942,0.5860149049850432,0.41398509501495684
175,Scotland,East Lothian,77788,71.73,55764,36026,19738,0.646044042751596,0.353955957248404
176,Scotland,East Renfrewshire,69575,76.13,52941,39345,13596,0.7431858106193687,0.2568141893806313
177,Scotland,Eilean Siar,21259,70.18,14903,8232,6671,0.5523720056364491,0.44762799436355094
178,Scotland,Falkirk,117392,67.55,79258,44987,34271,0.5676020086300436,0.4323979913699563
179,Scotland,Fife,272995,66.78,182220,106754,75466,0.5858522664910548,0.41414773350894524
180,Scotland,Highland,175563,71.61,125657,70308,55349,0.5595231463428221,0.44047685365717787
181,Scotland,Inverclyde,58624,66.05,38698,24688,14010,0.6379657863455476,0.36203421365445243
182,Scotland,Midlothian,66758,68.15,45468,28217,17251,0.6205903052696402,0.3794096947303598
183,Scotland,Moray,71370,67.45,48106,24114,23992,0.501268033093585,0.498731966906415
184,Scotland,North Ayrshire,104572,64.59,67504,38394,29110,0.568766295330647,0.4312337046693529
185,Scotland,Orkney Islands,16658,68.45,11382,7189,4193,0.6316113161131611,0.3683886838868389
186,Scotland,Perth and Kinross,110224,73.75,81255,49641,31614,0.6109285582425696,0.3890714417574303
187,Scotland,Scottish Borders,88440,73.44,64914,37952,26962,0.5846504606094217,0.4153495393905783
188,Scotland,Shetland Islands,17375,70.39,12222,6907,5315,0.5651284568810342,0.4348715431189658
189,Scotland,South Ayrshire,88116,69.84,61506,36265,25241,0.5896172731115663,0.41038272688843364
190,Scotland,South Lanarkshire,248949,65.35,162592,102568,60024,0.630830545168274,0.36916945483172603
191,Scotland,Stirling,66100,74.03,48899,33112,15787,0.6771508619808176,0.3228491380191824
192,Scotland,Aberdeen City,154266,67.94,104714,63985,40729,0.6110453234524514,0.38895467654754856
193,Scotland,Aberdeenshire,196809,70.63,138961,76445,62516,0.5501183785378632,0.44988162146213684
194,Scotland,Argyll and Bute,66642,73.13,48696,29494,19202,0.6056760308854937,0.39432396911450635
195,Scotland,City of Edinburgh,346073,72.96,252294,187796,64498,0.7443538094445369,0.25564619055546306
196,Scotland,Renfrewshire,127294,69.29,88129,57119,31010,0.6481294466066788,0.35187055339332113
197,Scotland,West Dunbartonshire,67595,63.98,43220,26794,16426,0.619944470152707,0.3800555298472929
198,Scotland,West Lothian,130925,67.64,88508,51560,36948,0.5825462105120441,0.4174537894879559
199,Scotland,Angus,87137,68.03,59258,32747,26511,0.5526173681190726,0.4473826318809275
200,Scotland,Dundee City,105554,62.92,66385,39688,26697,0.5978458989229495,0.4021541010770505
201,Scotland,North Lanarkshire,254567,60.91,154949,95549,59400,0.6166480583934069,0.38335194160659314
202,Scotland,East Dunbartonshire,83031,75.17,62374,44534,17840,0.7139833905152788,0.2860166094847212
203,Scotland,Glasgow City,449806,56.25,252809,168335,84474,0.6658584148507372,0.3341415851492629
204,South East,Medway,192524,72.18,138886,49889,88997,0.3592082715320479,0.6407917284679522
205,South East,Bracknell Forest,85298,76.11,64890,29888,35002,0.46059485282786256,0.5394051471721375
206,South East,West Berkshire,116757,79.95,93277,48300,44977,0.5178125368526003,0.4821874631473997
207,South East,Reading,103172,72.53,74767,43385,31382,0.5802693701766822,0.41973062982331777
208,South East,Slough,87873,62.13,54542,24911,29631,0.4567305929375527,0.5432694070624473
209,South East,Windsor and Maidenhead,102665,79.73,81792,44086,37706,0.5390013693270735,0.46099863067292646
210,South East,Wokingham,121891,80.03,97501,55272,42229,0.5668864934718618,0.4331135065281382
211,South East,Milton Keynes,177211,73.66,130456,63393,67063,0.48593395474336176,0.5140660452566382
212,South East,Brighton and Hove,198293,74.05,146675,100648,46027,0.6861973751491393,0.31380262485086075
213,South East,Portsmouth,140517,70.3,98720,41384,57336,0.4192058346839546,0.5807941653160453
214,South East,Southampton,158171,68.14,107665,49738,57927,0.46196999953559653,0.5380300004644035
215,South East,Isle of Wight,109844,72.31,79380,30207,49173,0.3805366591080877,0.6194633408919124
216,South East,Aylesbury Vale,136235,78.46,106833,52877,53956,0.4949500622466841,0.505049937753316
217,South East,Chiltern,70185,83.57,58604,32241,26363,0.5501501603986076,0.4498498396013924
218,South East,South Bucks,52194,78.08,40724,20077,20647,0.49300166977703563,0.5069983302229644
219,South East,Wycombe,125260,75.74,94790,49261,45529,0.5196856208460808,0.48031437915391917
220,South East,Eastbourne,71726,74.73,53545,22845,30700,0.4266504809039126,0.5733495190960874
221,South East,Hastings,61957,71.64,44350,20011,24339,0.45120631341600903,0.548793686583991
222,South East,Lewes,76428,77.89,59482,30974,28508,0.5207289600215191,0.47927103997848086
223,South East,Rother,72755,79.33,57669,23916,33753,0.41471154346355926,0.5852884565364407
224,South East,Wealden,121141,80.03,96892,44084,52808,0.45498080336869917,0.5450191966313008
225,South East,Basingstoke and Deane,128677,78.02,100328,48257,52071,0.4809923451080456,0.5190076548919544
226,South East,East Hampshire,90588,81.65,73922,37346,36576,0.5052081924190363,0.4947918075809637
227,South East,Eastleigh,97280,78.28,76074,36172,39902,0.4754843967715645,0.5245156032284355
228,South East,Fareham,90175,79.59,71735,32210,39525,0.4490137310936084,0.5509862689063916
229,South East,Gosport,62781,73.51,46127,16671,29456,0.36141522318815444,0.6385847768118456
230,South East,Hart,69946,82.67,57795,30282,27513,0.5239553594601609,0.4760446405398391
231,South East,Havant,95366,74.1,70629,26582,44047,0.37636098486457403,0.623639015135426
232,South East,New Forest,141061,79.25,111740,47199,64541,0.42240021478432077,0.5775997852156792
233,South East,Rushmoor,65790,74.18,48780,20384,28396,0.4178761787617876,0.5821238212382124
234,South East,Test Valley,94559,79.65,75261,36170,39091,0.4805941988546525,0.5194058011453475
235,South East,Winchester,89595,81.26,72764,42878,29886,0.5892749161673355,0.4107250838326645
236,South East,Ashford,90516,77.14,69786,28314,41472,0.4057260768635543,0.5942739231364457
237,South East,Canterbury,109399,75.05,82048,40169,41879,0.48957927067082685,0.5104207293291732
238,South East,Dartford,73951,75.57,55855,19985,35870,0.3578014501835109,0.6421985498164892
239,South East,Dover,85011,76.53,65016,24606,40410,0.3784606866002215,0.6215393133997785
240,South East,Gravesham,72808,74.93,54519,18876,35643,0.3462279205414626,0.6537720794585374
241,South East,Maidstone,117298,76.02,89127,36762,52365,0.4124676024100441,0.5875323975899559
242,South East,Sevenoaks,87253,80.68,70349,32091,38258,0.4561685311802584,0.5438314688197415
243,South East,Shepway,80879,75.0,60613,22884,37729,0.3775427713526801,0.6224572286473199
244,South East,Swale,102209,74.27,75869,28481,47388,0.37539706599533407,0.6246029340046659
245,South East,Thanet,99108,72.8,72102,26065,46037,0.3615017613935813,0.6384982386064186
246,South East,Tonbridge and Malling,93019,79.62,74021,32792,41229,0.4430094162467408,0.5569905837532592
247,South East,Tunbridge Wells,82181,79.14,64996,35676,29320,0.5488953166348698,0.45110468336513015
248,South East,Cherwell,108342,75.6,81836,40668,41168,0.49694510973165845,0.5030548902683416
249,South East,Oxford,97331,72.34,70337,49424,20913,0.7026742681661146,0.29732573183388544
250,South East,South Oxfordshire,104231,80.75,84110,46245,37865,0.5498157175127809,0.45018428248721915
251,South East,Vale of White Horse,94487,81.18,76654,43462,33192,0.5669893286716936,0.4330106713283064
252,South East,West Oxfordshire,82441,79.72,65671,35236,30435,0.5365534254084756,0.46344657459152444
253,South East,Elmbridge,98613,78.14,77003,45841,31162,0.5953144682674701,0.4046855317325299
254,South East,Epsom and Ewell,56382,80.42,45303,23596,21707,0.5208485089287685,0.4791514910712315
255,South East,Guildford,102209,76.96,78613,44155,34458,0.5616755498454454,0.43832445015455457
256,South East,Mole Valley,66730,82.17,54796,29088,25708,0.5308416672749836,0.46915833272501645
257,South East,Reigate and Banstead,103731,78.28,81161,40181,40980,0.49507768509505795,0.504922314904942
258,South East,Runnymede,58272,76.07,44294,20259,24035,0.4573757168013726,0.5426242831986273
259,South East,Spelthorne,72674,77.93,56609,22474,34135,0.39700400996308005,0.60299599003692
260,South East,Surrey Heath,65569,79.81,52305,25638,26667,0.4901634642959564,0.5098365357040436
261,South East,Tandridge,64044,80.36,51420,24251,27169,0.4716258265266433,0.5283741734733567
262,South East,Waverley,92291,82.35,75942,44341,31601,0.5838798030075584,0.4161201969924416
263,South East,Woking,71313,77.49,55221,31007,24214,0.5615073975480342,0.43849260245196575
264,South East,Adur,48755,76.4,37229,16914,20315,0.45432324263343093,0.5456767573665691
265,South East,Arun,117138,77.86,91129,34193,56936,0.3752153540585324,0.6247846459414675
266,South East,Chichester,91659,77.91,71337,35011,36326,0.49078318404194177,0.5092168159580582
267,South East,Crawley,73575,73.24,53835,22388,31447,0.4158632859663787,0.5841367140336212
268,South East,Horsham,104270,81.65,85088,43785,41303,0.5145849003384732,0.4854150996615269
269,South East,Mid Sussex,108416,80.79,87528,46471,41057,0.5309272461383786,0.46907275386162145
270,South East,Worthing,81384,75.46,61366,28851,32515,0.47014633510412934,0.5298536648958707
271,South West,Bath and North East Somerset,136522,77.13,105230,60878,44352,0.578523234818968,0.421476765181032
272,South West,"Bristol, City of",312465,73.17,228445,141027,87418,0.6173345881940948,0.38266541180590513
273,South West,North Somerset,160860,77.47,124548,59572,64976,0.4783055528792112,0.5216944471207887
274,South West,South Gloucestershire,207793,76.24,158333,74928,83405,0.4732304699588841,0.5267695300411159
275,South West,Plymouth,186989,71.41,133455,53458,79997,0.4005694803491814,0.5994305196508186
276,South West,Torbay,102961,73.69,75824,27935,47889,0.3684189702468875,0.6315810297531125
277,South West,Bournemouth,132752,69.3,91926,41473,50453,0.45115636490220395,0.5488436350977961
278,South West,Poole,113421,75.38,85448,35741,49707,0.4182777829791218,0.5817222170208782
279,South West,Swindon,148960,75.9,112965,51220,61745,0.4534147744876732,0.5465852255123268
280,South West,Cornwall,419755,77.05,323205,140540,182665,0.4348323819247846,0.5651676180752154
281,South West,Isles of Scilly,1799,79.16,1424,803,621,0.5639044943820225,0.43609550561797755
282,South West,Wiltshire,366555,78.87,288895,137258,151637,0.47511379566970696,0.524886204330293
283,South West,East Devon,112527,78.94,88783,40743,48040,0.458905421082865,0.5410945789171351
284,South West,Exeter,86417,73.91,63803,35270,28533,0.5527953231039293,0.44720467689607074
285,South West,Mid Devon,60532,79.38,48006,22400,25606,0.4666083406240887,0.5333916593759114
286,South West,North Devon,75548,76.85,58031,24931,33100,0.4296152056659372,0.5703847943340629
287,South West,South Hams,69121,80.27,55450,29308,26142,0.5285482416591524,0.4714517583408476
288,South West,Teignbridge,103740,79.4,82312,37949,44363,0.46103848770531636,0.5389615122946837
289,South West,Torridge,52881,78.41,41429,16229,25200,0.3917304303748582,0.6082695696251418
290,South West,West Devon,43823,81.26,35595,16658,18937,0.4679870768366344,0.5320129231633657
291,South West,Christchurch,39176,79.3,31050,12782,18268,0.411658615136876,0.588341384863124
292,South West,East Dorset,71966,81.33,58488,24786,33702,0.4237792367665162,0.5762207632334838
293,South West,North Dorset,52980,79.71,42201,18399,23802,0.435984929267079,0.564015070732921
294,South West,Purbeck,36418,78.91,28720,11754,16966,0.40926183844011144,0.5907381615598886
295,South West,West Dorset,82071,79.49,65191,31924,33267,0.489699498397018,0.510300501602982
296,South West,Weymouth and Portland,50442,75.87,38255,14903,23352,0.3895699908508692,0.6104300091491308
297,South West,Cheltenham,87060,75.88,66013,37081,28932,0.561722690985109,0.438277309014891
298,South West,Cotswold,68734,79.8,54821,28015,26806,0.5110267963006877,0.4889732036993123
299,South West,Forest of Dean,66705,77.47,51643,21392,30251,0.41422845303332495,0.5857715469666751
300,South West,Gloucester,89661,72.06,64577,26801,37776,0.41502392492683154,0.5849760750731685
301,South West,Stroud,92631,80.03,74064,40446,33618,0.5460952689565781,0.4539047310434219
302,South West,Tewkesbury,67831,79.15,53652,25084,28568,0.4675314992917319,0.5324685007082681
303,South West,Mendip,85068,77.01,65455,33427,32028,0.5106867313421435,0.4893132686578565
304,South West,Sedgemoor,89714,76.3,68414,26545,41869,0.38800537901599086,0.6119946209840091
305,South West,South Somerset,126495,78.69,99467,42527,56940,0.4275488352921069,0.572451164707893
306,South West,Taunton Deane,84164,78.16,65733,30944,34789,0.47075289428445377,0.5292471057155462
307,South West,West Somerset,27478,79.17,21734,8566,13168,0.3941290144474096,0.6058709855525904
308,South West,Gibraltar,24119,83.64,20145,19322,823,0.9591461901216183,0.04085380987838173
309,Wales,Isle of Anglesey,51445,73.82,37951,18618,19333,0.49057995836736845,0.5094200416326315
310,Wales,Gwynedd,84575,72.42,61182,35517,25665,0.5805138766303815,0.4194861233696185
311,Wales,Conwy,91368,71.75,65504,30147,35357,0.46023143624816804,0.5397685637518319
312,Wales,Denbighshire,75362,69.14,52072,23955,28117,0.4600361038561991,0.5399638961438009
313,Wales,Flintshire,115964,74.9,86797,37867,48930,0.43627083885387746,0.5637291611461226
314,Wales,Wrexham,98384,71.56,70366,28822,41544,0.4096012278657306,0.5903987721342694
315,Wales,Ceredigion,53400,74.48,39742,21711,18031,0.5462986261385939,0.4537013738614061
316,Wales,Pembrokeshire,92155,74.39,68522,29367,39155,0.42857768307988675,0.5714223169201132
317,Wales,Carmarthenshire,139227,74.07,103035,47654,55381,0.4625030329499685,0.5374969670500316
318,Wales,Swansea,172941,69.6,120243,58307,61936,0.48490972447460556,0.5150902755253944
319,Wales,Neath Port Talbot,105766,71.57,75652,32651,43001,0.4315946703325755,0.5684053296674245
320,Wales,Bridgend,104492,71.18,74345,33723,40622,0.453601452686798,0.5463985473132019
321,Wales,Vale of Glamorgan,95011,76.15,72309,36681,35628,0.5072812512965191,0.49271874870348087
322,Wales,Cardiff,243689,69.66,169604,101788,67816,0.6001509398363246,0.3998490601636754
323,Wales,Rhondda Cynon Taf,172890,67.47,116563,53973,62590,0.4630371558727898,0.5369628441272102
324,Wales,Caerphilly,130801,70.74,92473,39178,53295,0.42366961167043354,0.5763303883295665
325,Wales,Blaenau Gwent,51136,68.08,34802,13215,21587,0.37971955634733634,0.6202804436526637
326,Wales,Torfaen,68957,69.86,48144,19363,28781,0.4021892655367232,0.5978107344632768
327,Wales,Monmouthshire,71607,77.74,55630,28061,27569,0.5044220744202769,0.4955779255797232
328,Wales,Newport,104977,70.21,73649,32413,41236,0.4401010197015574,0.5598989802984427
329,Wales,Powys,103270,77.0,79469,36762,42707,0.46259547748178537,0.5374045225182147
330,Wales,Merthyr Tydfil,42855,67.39,28865,12574,16291,0.43561406547722153,0.5643859345227784
331,West Midlands,"Herefordshire, County of",138247,78.36,108270,44148,64122,0.4077583818232197,0.5922416181767802
332,West Midlands,Telford and Wrekin,124338,72.15,89603,32954,56649,0.367777864580427,0.632222135419573
333,West Midlands,Stoke-on-Trent,179010,65.74,117590,36027,81563,0.30637809337528704,0.693621906624713
334,West Midlands,Shropshire,236788,77.42,183153,78987,104166,0.4312623871844851,0.5687376128155149
335,West Midlands,Cannock Chase,75010,71.47,53578,16684,36894,0.3113964686998395,0.6886035313001605
336,West Midlands,East Staffordshire,83558,74.39,62116,22850,39266,0.36786013265503253,0.6321398673449675
337,West Midlands,Lichfield,80369,78.78,63278,26064,37214,0.41189670975694553,0.5881032902430544
338,West Midlands,Newcastle-under-Lyme,92816,74.3,68934,25477,43457,0.36958540052804134,0.6304145994719587
339,West Midlands,South Staffordshire,85777,77.81,66692,23444,43248,0.35152641996041506,0.648473580039585
340,West Midlands,Stafford,99612,77.83,77484,34098,43386,0.44006504568685145,0.5599349543131485
341,West Midlands,Staffordshire Moorlands,79347,75.36,59760,21076,38684,0.3526773761713521,0.6473226238286479
342,West Midlands,Tamworth,56825,74.18,42129,13705,28424,0.3253103562866434,0.6746896437133566
343,West Midlands,North Warwickshire,49790,76.27,37954,12569,25385,0.33116404068082417,0.6688359593191758
344,West Midlands,Nuneaton and Bedworth,93978,74.35,69831,23736,46095,0.339906345319414,0.660093654680586
345,West Midlands,Rugby,74137,79.03,58549,25350,33199,0.4329706741361936,0.5670293258638064
346,West Midlands,Stratford-on-Avon,98014,80.82,79158,38341,40817,0.48436039313777507,0.5156396068622249
347,West Midlands,Warwick,103099,79.22,81618,47976,33642,0.5878115121664339,0.41218848783356615
348,West Midlands,Bromsgrove,74170,79.35,58815,26252,32563,0.4463487205644818,0.5536512794355182
349,West Midlands,Malvern Hills,60217,80.61,48497,23203,25294,0.478441965482401,0.5215580345175991
350,West Midlands,Redditch,61038,75.22,45882,17303,28579,0.37711956758641735,0.6228804324135827
351,West Midlands,Worcester,73516,73.85,54239,25125,29114,0.46322756687992034,0.5367724331200796
352,West Midlands,Wychavon,94497,80.88,76389,32188,44201,0.4213695689169907,0.5786304310830094
353,West Midlands,Wyre Forest,77878,74.05,57632,21240,36392,0.36854525263742366,0.6314547473625763
354,West Midlands,Birmingham,707293,63.81,450702,223451,227251,0.4957843541852488,0.5042156458147512
355,West Midlands,Coventry,221389,69.21,153064,67967,85097,0.444043014686667,0.5559569853133329
356,West Midlands,Dudley,244516,71.71,175226,56780,118446,0.3240386700603792,0.6759613299396209
357,West Midlands,Sandwell,221429,66.58,147254,49004,98250,0.33278552704850123,0.6672144729514987
358,West Midlands,Solihull,160425,76.06,121950,53466,68484,0.43842558425584255,0.5615744157441575
359,West Midlands,Walsall,194729,69.68,135579,43572,92007,0.32137720443431506,0.6786227955656849
360,West Midlands,Wolverhampton,174760,67.54,117936,44138,73798,0.37425383258716594,0.6257461674128341
361,Yorkshire and The Humber,"Kingston upon Hull, City of",180230,62.94,113355,36709,76646,0.32384103039124873,0.6761589696087512
362,Yorkshire and The Humber,East Riding of Yorkshire,266047,74.81,198915,78779,120136,0.3960435361837971,0.6039564638162029
363,Yorkshire and The Humber,North East Lincolnshire,116302,67.94,78982,23797,55185,0.30129649793623864,0.6987035020637614
364,Yorkshire and The Humber,North Lincolnshire,123611,71.92,88862,29947,58915,0.3370056942225023,0.6629943057774977
365,Yorkshire and The Humber,York,155157,70.69,109600,63617,45983,0.5804470802919708,0.4195529197080292
366,Yorkshire and The Humber,Craven,44320,81.02,35891,16930,18961,0.4717059987183416,0.5282940012816584
367,Yorkshire and The Humber,Hambleton,70133,78.45,54982,25480,29502,0.4634243934378524,0.5365756065621476
368,Yorkshire and The Humber,Harrogate,119987,78.89,94585,48211,46374,0.5097108420996986,0.4902891579003013
369,Yorkshire and The Humber,Richmondshire,36794,75.15,27636,11945,15691,0.4322260819221306,0.5677739180778695
370,Yorkshire and The Humber,Ryedale,41529,77.22,32050,14340,17710,0.4474258970358814,0.5525741029641186
371,Yorkshire and The Humber,Scarborough,82900,73.03,60511,22999,37512,0.38007965493877144,0.6199203450612285
372,Yorkshire and The Humber,Selby,65278,79.1,51603,21071,30532,0.40832897312171773,0.5916710268782823
373,Yorkshire and The Humber,Barnsley,175809,69.95,122909,38951,83958,0.31690925806897785,0.6830907419310221
374,Yorkshire and The Humber,Doncaster,217432,69.56,151182,46922,104260,0.3103676363588258,0.6896323636411742
375,Yorkshire and The Humber,Rotherham,197623,69.56,137387,44115,93272,0.32110024965972034,0.6788997503402796
376,Yorkshire and The Humber,Sheffield,396406,67.34,266753,130735,136018,0.49009758090818095,0.509902419091819
377,Yorkshire and The Humber,Bradford,342817,66.72,228488,104575,123913,0.45768267917789995,0.5423173208221
378,Yorkshire and The Humber,Calderdale,149195,71.05,105925,46950,58975,0.44323814019353314,0.5567618598064669
379,Yorkshire and The Humber,Kirklees,307081,70.8,217240,98485,118755,0.4533465291843123,0.5466534708156877
380,Yorkshire and The Humber,Leeds,543033,71.39,387337,194863,192474,0.5030838778634625,0.4969161221365374
381,Yorkshire and The Humber,Wakefield,246096,71.17,175042,58877,116165,0.33635927377429414,0.6636407262257058
